2 1 7 4 4 3 5
7 7 4 2 6 3 4 
6 5 1 3 7 7 4
 4 6 3 3 1 5 6
4 2 1 1 7 4 2
3 4 2 5 7 6 1
1 3 6 6 3 6 7
