5 3 1 5 3 2 6 
2 7 4 5 6 3 1 
3 4 1 2 2 5 3 
4 1 7 6 5 4 2 
7 3 3 2 1 3 4 
6 5 1 7 5 2 3 
1 2 5 4 7 1 5